WE./textures/we.xpm
NO./textures/no.xpm
SO./textures/so.xpm
EA./textures/ea.xpm

C 225,30,50
F 20,20,20

111111
1000011
110000011
101110111111111
11000010000000111
111000001111100001
100011000011 11101
11111111011    1001
       1011     101
       1001     101
       10001    101
       11001    101
       110011   101
    111100001   10111111
    100000001   100000001
    1001100011   11111101
    10010000011111111 101
    100000000000000011101
    111000000000011000001
      10100N001111 11111
      111111111
